111111111111111111111111111111111
100000000000001000000000000000001
101111111110111011111111111111101
101000000010001010001000100000001
101010111111101010101010101111101
100010100000101000100010101000101
111110101110101011111110101010101
100000101010000000000010101010101
101111101011111111111010101010101
101000001000000000000010101010101
101011111010111111111010101010101
101010000010100000001010101010101
101010111010101111101010101010101
101010001010100000001000101010101
101011101011101111111110101110101
101000000010001000000010100010101
101110111010101000111011111010101
100010000010101000101000000010101
111011111110101111101111111110101
100010000010101000001000001000101
101110111010101011101011101011101
101000001000001000101000101000101
101011101111101110101110101110101
101010001000000000101000100000101
101010101010101111101011111111101
100010101010100000101000001000001
111110101011111110101111101011111
100000101010000010100000101010001
101111101010111010111110101010101
100000001010001010000010001000101
101011111011101011111011111011101
101000000000001000001000000000001
111111111111111111111111111111111